############################
#............##............#
#.########################.#
#.# # # # # # # # # # #  #.#
#.########################.#
#..........................#
#.####.##. #    # .##.####.#
#.####.##.########.##.####.#
#......##....##....##......#
######.##### ## #####.######
     #.##### ## #####.#
     #.##   ....   ##.#
     #.## ###  ### ##.#
######.## # $  % # ##.######
   ....   # $  % #   ....
######.## # $  % # ##.######
     #.## ######## ##.#
     #.## ........ ##.#
######.## ######## ##.######
#............##............#
#.####.#####.##.#####.####.#
#.####.#####.##.#####.####.#
######........@.......######
###.##.##.########.##.##.###
###.##.##.########.##.##.###
#......##....##....##......#
#.##########.##.##########.#
#.##########.##.##########.#
#..........................#
############################